"filename", "language", "C#", "Markdown", "JSON", "Hjson", "XML", "comment", "blank", "total"
"c:\Users\Karl\Documents\My Games\Terraria\tModLoader\ModSources\ChargerClass\ChargerClass.cs", "C#", -31, 0, 0, 0, 0, -1, -3, -35
"c:\Users\Karl\Documents\My Games\Terraria\tModLoader\ModSources\ChargerClass\ChargerClass.csproj", "XML", 0, 0, 0, 0, -13, 0, 0, -13
"c:\Users\Karl\Documents\My Games\Terraria\tModLoader\ModSources\ChargerClass\Common\Configs\Config.cs", "C#", -15, 0, 0, 0, 0, -3, -3, -21
"c:\Users\Karl\Documents\My Games\Terraria\tModLoader\ModSources\ChargerClass\Common\DrawLayers\AnimatedDrawLayer.cs", "C#", -56, 0, 0, 0, 0, -1, -15, -72
"c:\Users\Karl\Documents\My Games\Terraria\tModLoader\ModSources\ChargerClass\Common\DrawLayers\CentrifugalGunDrawLayer.cs", "C#", -39, 0, 0, 0, 0, 0, -6, -45
"c:\Users\Karl\Documents\My Games\Terraria\tModLoader\ModSources\ChargerClass\Common\DrawLayers\PremeCalamariDrawLayer.cs", "C#", -29, 0, 0, 0, 0, 0, -3, -32
"c:\Users\Karl\Documents\My Games\Terraria\tModLoader\ModSources\ChargerClass\Common\DrawLayers\SupremeCalamariDrawLayer.cs", "C#", -32, 0, 0, 0, 0, 0, -4, -36
"c:\Users\Karl\Documents\My Games\Terraria\tModLoader\ModSources\ChargerClass\Common\Extensions\Explosions.cs", "C#", -68, 0, 0, 0, 0, 0, -4, -72
"c:\Users\Karl\Documents\My Games\Terraria\tModLoader\ModSources\ChargerClass\Common\Extensions\Targeting.cs", "C#", -57, 0, 0, 0, 0, 0, -2, -59
"c:\Users\Karl\Documents\My Games\Terraria\tModLoader\ModSources\ChargerClass\Common\GlobalNPCs\ModGlobalNPC.cs", "C#", -85, 0, 0, 0, 0, -1, -4, -90
"c:\Users\Karl\Documents\My Games\Terraria\tModLoader\ModSources\ChargerClass\Common\GlobalNPCs\ModInstanceNPC.cs", "C#", -102, 0, 0, 0, 0, -1, -7, -110
"c:\Users\Karl\Documents\My Games\Terraria\tModLoader\ModSources\ChargerClass\Common\GlobalProjectiles\ChargerProjectle.cs", "C#", -168, 0, 0, 0, 0, -1, -11, -180
"c:\Users\Karl\Documents\My Games\Terraria\tModLoader\ModSources\ChargerClass\Common\ItemDropRules\DropConditions\BlueChargeDropCondition.cs", "C#", -17, 0, 0, 0, 0, 0, -5, -22
"c:\Users\Karl\Documents\My Games\Terraria\tModLoader\ModSources\ChargerClass\Common\ItemDropRules\DropConditions\ChargeDropCondition.cs", "C#", -17, 0, 0, 0, 0, 0, -5, -22
"c:\Users\Karl\Documents\My Games\Terraria\tModLoader\ModSources\ChargerClass\Common\ItemDropRules\DropConditions\OrangeChargeDropCondition.cs", "C#", -17, 0, 0, 0, 0, 0, -5, -22
"c:\Users\Karl\Documents\My Games\Terraria\tModLoader\ModSources\ChargerClass\Common\Item\GlobalItem.cs", "C#", -88, 0, 0, 0, 0, 0, -2, -90
"c:\Users\Karl\Documents\My Games\Terraria\tModLoader\ModSources\ChargerClass\Common\ModSystems\ChargerClassGeneralSystem.cs", "C#", -117, 0, 0, 0, 0, -3, -21, -141
"c:\Users\Karl\Documents\My Games\Terraria\tModLoader\ModSources\ChargerClass\Common\ModSystems\ChargerClassOreSystem.cs", "C#", -46, 0, 0, 0, 0, -6, -13, -65
"c:\Users\Karl\Documents\My Games\Terraria\tModLoader\ModSources\ChargerClass\Common\ModSystems\ChargerMeterUISystem.cs", "C#", -64, 0, 0, 0, 0, -9, -6, -79
"c:\Users\Karl\Documents\My Games\Terraria\tModLoader\ModSources\ChargerClass\Common\ModSystems\DartAssemblyStationUISystem.cs", "C#", -71, 0, 0, 0, 0, 0, -7, -78
"c:\Users\Karl\Documents\My Games\Terraria\tModLoader\ModSources\ChargerClass\Common\Players\ChargeModPlayer.cs", "C#", -311, 0, 0, 0, 0, -1, -54, -366
"c:\Users\Karl\Documents\My Games\Terraria\tModLoader\ModSources\ChargerClass\Common\Sets\Sets.cs", "C#", -53, 0, 0, 0, 0, 0, -3, -56
"c:\Users\Karl\Documents\My Games\Terraria\tModLoader\ModSources\ChargerClass\Content\Buffs\Cursed.cs", "C#", 17, 0, 0, 0, 0, 0, 2, 19
"c:\Users\Karl\Documents\My Games\Terraria\tModLoader\ModSources\ChargerClass\Content\Dusts\ConsumingDust.cs", "C#", 24, 0, 0, 0, 0, 0, 5, 29
"c:\Users\Karl\Documents\My Games\Terraria\tModLoader\ModSources\ChargerClass\Content\Items\Acessories\AAABattery.cs", "C#", 3, 0, 0, 0, 0, 0, 0, 3
"c:\Users\Karl\Documents\My Games\Terraria\tModLoader\ModSources\ChargerClass\Content\Items\Acessories\BreathingAid.cs", "C#", 3, 0, 0, 0, 0, 0, 0, 3
"c:\Users\Karl\Documents\My Games\Terraria\tModLoader\ModSources\ChargerClass\Content\Items\Acessories\CarBattery.cs", "C#", 3, 0, 0, 0, 0, 0, 0, 3
"c:\Users\Karl\Documents\My Games\Terraria\tModLoader\ModSources\ChargerClass\Content\Items\Acessories\ChargeRepository.cs", "C#", 3, 0, 0, 0, 0, 0, 0, 3
"c:\Users\Karl\Documents\My Games\Terraria\tModLoader\ModSources\ChargerClass\Content\Items\Acessories\Charger.cs", "C#", 3, 0, 0, 0, 0, 0, 0, 3
"c:\Users\Karl\Documents\My Games\Terraria\tModLoader\ModSources\ChargerClass\Content\Items\Acessories\ChargerEmblem.cs", "C#", 3, 0, 0, 0, 0, 0, 0, 3
"c:\Users\Karl\Documents\My Games\Terraria\tModLoader\ModSources\ChargerClass\Content\Items\Acessories\Diaphragm.cs", "C#", 3, 0, 0, 0, 0, 0, 0, 3
"c:\Users\Karl\Documents\My Games\Terraria\tModLoader\ModSources\ChargerClass\Content\Items\Acessories\Exhaler.cs", "C#", 4, 0, 0, 0, 0, 0, 0, 4
"c:\Users\Karl\Documents\My Games\Terraria\tModLoader\ModSources\ChargerClass\Content\Items\Acessories\ExtensionCord.cs", "C#", 3, 0, 0, 0, 0, 0, 0, 3
"c:\Users\Karl\Documents\My Games\Terraria\tModLoader\ModSources\ChargerClass\Content\Items\Acessories\Generator.cs", "C#", 4, 0, 0, 0, 0, 0, 0, 4
"c:\Users\Karl\Documents\My Games\Terraria\tModLoader\ModSources\ChargerClass\Content\Items\Acessories\GripTape.cs", "C#", 3, 0, 0, 0, 0, 0, 1, 4
"c:\Users\Karl\Documents\My Games\Terraria\tModLoader\ModSources\ChargerClass\Content\Items\Acessories\Haler.cs", "C#", 1, 0, 0, 0, 0, 0, 0, 1
"c:\Users\Karl\Documents\My Games\Terraria\tModLoader\ModSources\ChargerClass\Content\Items\Acessories\IronLung.cs", "C#", 3, 0, 0, 0, 0, 0, 0, 3
"c:\Users\Karl\Documents\My Games\Terraria\tModLoader\ModSources\ChargerClass\Content\Items\Acessories\Overcharger.cs", "C#", 2, 0, 0, 0, 0, 0, 0, 2
"c:\Users\Karl\Documents\My Games\Terraria\tModLoader\ModSources\ChargerClass\Content\Items\Acessories\PowerBank.cs", "C#", 3, 0, 0, 0, 0, 0, 1, 4
"c:\Users\Karl\Documents\My Games\Terraria\tModLoader\ModSources\ChargerClass\Content\Items\Acessories\RedDot.cs", "C#", 3, 0, 0, 0, 0, 0, 0, 3
"c:\Users\Karl\Documents\My Games\Terraria\tModLoader\ModSources\ChargerClass\Content\Items\Acessories\Respirator.cs", "C#", 3, 0, 0, 0, 0, 0, 0, 3
"c:\Users\Karl\Documents\My Games\Terraria\tModLoader\ModSources\ChargerClass\Content\Items\Acessories\ShootingGlove.cs", "C#", 3, 0, 0, 0, 0, 0, 0, 3
"c:\Users\Karl\Documents\My Games\Terraria\tModLoader\ModSources\ChargerClass\Content\Items\Acessories\TrackingSpec.cs", "C#", -39, 0, 0, 0, 0, 0, -3, -42
"c:\Users\Karl\Documents\My Games\Terraria\tModLoader\ModSources\ChargerClass\Content\Items\Acessories\TrackingSpecs.cs", "C#", 42, 0, 0, 0, 0, 0, 3, 45
"c:\Users\Karl\Documents\My Games\Terraria\tModLoader\ModSources\ChargerClass\Content\Items\Acessories\UltimateChargingGear.cs", "C#", 3, 0, 0, 0, 0, 0, 0, 3
"c:\Users\Karl\Documents\My Games\Terraria\tModLoader\ModSources\ChargerClass\Content\Items\Ammo\BloontoniumDart.cs", "C#", 28, 0, 0, 0, 0, 0, 5, 33
"c:\Users\Karl\Documents\My Games\Terraria\tModLoader\ModSources\ChargerClass\Content\Items\Ammo\Darts\CustomDart.cs", "C#", 14, 0, 0, 0, 0, 0, 1, 15
"c:\Users\Karl\Documents\My Games\Terraria\tModLoader\ModSources\ChargerClass\Content\Items\Ammo\Darts\Tails\BetsysBackwash.cs", "C#", 10, 0, 0, 0, 0, 0, 1, 11
"c:\Users\Karl\Documents\My Games\Terraria\tModLoader\ModSources\ChargerClass\Content\Items\Ammo\Darts\Tails\HolyLightTail.cs", "C#", 7, 0, 0, 0, 0, 0, 1, 8
"c:\Users\Karl\Documents\My Games\Terraria\tModLoader\ModSources\ChargerClass\Content\Items\Ammo\Darts\Tails\MagesTail.cs", "C#", 14, 0, 0, 0, 0, 0, 0, 14
"c:\Users\Karl\Documents\My Games\Terraria\tModLoader\ModSources\ChargerClass\Content\Items\Ammo\Darts\Tails\PrismaticTail.cs", "C#", 29, 0, 0, 0, 0, 0, 2, 31
"c:\Users\Karl\Documents\My Games\Terraria\tModLoader\ModSources\ChargerClass\Content\Items\Ammo\Darts\Tails\TheCorruptor.cs", "C#", 4, 0, 0, 0, 0, 0, 2, 6
"c:\Users\Karl\Documents\My Games\Terraria\tModLoader\ModSources\ChargerClass\Content\Items\Ammo\Darts\Tails\UnholyTail.cs", "C#", 20, 0, 0, 0, 0, 0, 1, 21
"c:\Users\Karl\Documents\My Games\Terraria\tModLoader\ModSources\ChargerClass\Content\Items\Ammo\MonkeyDart.cs", "C#", 28, 0, 0, 0, 0, 0, 5, 33
"c:\Users\Karl\Documents\My Games\Terraria\tModLoader\ModSources\ChargerClass\Content\Items\Ammo\RocketPod.cs", "C#", 28, 0, 0, 0, 0, 0, 5, 33
"c:\Users\Karl\Documents\My Games\Terraria\tModLoader\ModSources\ChargerClass\Content\Items\Ammo\SoulofBunnies.cs", "C#", 31, 0, 0, 0, 0, 0, 6, 37
"c:\Users\Karl\Documents\My Games\Terraria\tModLoader\ModSources\ChargerClass\Content\Items\Armor\ChlorophyteCasque.cs", "C#", -1, 0, 0, 0, 0, 0, 0, -1
"c:\Users\Karl\Documents\My Games\Terraria\tModLoader\ModSources\ChargerClass\Content\Items\ConcentratedGelSolution.cs", "C#", 27, 0, 0, 0, 0, 0, 4, 31
"c:\Users\Karl\Documents\My Games\Terraria\tModLoader\ModSources\ChargerClass\Content\Items\Consumables\ChargePotion.cs", "C#", 3, 0, 0, 0, 0, 0, 0, 3
"c:\Users\Karl\Documents\My Games\Terraria\tModLoader\ModSources\ChargerClass\Content\Items\Consumables\FrightfulVoltaicScrap.cs", "C#", 2, 0, 0, 0, 0, 0, 0, 2
"c:\Users\Karl\Documents\My Games\Terraria\tModLoader\ModSources\ChargerClass\Content\Items\Consumables\ImpatiencePotion.cs", "C#", 3, 0, 0, 0, 0, 0, 0, 3
"c:\Users\Karl\Documents\My Games\Terraria\tModLoader\ModSources\ChargerClass\Content\Items\Consumables\MightyVoltaicScrap.cs", "C#", 2, 0, 0, 0, 0, 0, 0, 2
"c:\Users\Karl\Documents\My Games\Terraria\tModLoader\ModSources\ChargerClass\Content\Items\Consumables\OpticVoltaicScrap.cs", "C#", 2, 0, 0, 0, 0, 0, 0, 2
"c:\Users\Karl\Documents\My Games\Terraria\tModLoader\ModSources\ChargerClass\Content\Items\Consumables\StaminaPotion.cs", "C#", 3, 0, 0, 0, 0, 0, 0, 3
"c:\Users\Karl\Documents\My Games\Terraria\tModLoader\ModSources\ChargerClass\Content\Items\Consumables\VoltaicNugget.cs", "C#", 2, 0, 0, 0, 0, 0, 0, 2
"c:\Users\Karl\Documents\My Games\Terraria\tModLoader\ModSources\ChargerClass\Content\Items\ExoticEscargot.cs", "C#", 28, 0, 0, 0, 0, 0, 4, 32
"c:\Users\Karl\Documents\My Games\Terraria\tModLoader\ModSources\ChargerClass\Content\Items\Placeable\UnstableChaosShard.cs", "C#", 3, 0, 0, 0, 0, 0, 0, 3
"c:\Users\Karl\Documents\My Games\Terraria\tModLoader\ModSources\ChargerClass\Content\Items\VoodooBunny.cs", "C#", 41, 0, 0, 0, 0, 0, 5, 46
"c:\Users\Karl\Documents\My Games\Terraria\tModLoader\ModSources\ChargerClass\Content\Items\Weapons\Airgun.cs", "C#", 6, 0, 0, 0, 0, 0, 1, 7
"c:\Users\Karl\Documents\My Games\Terraria\tModLoader\ModSources\ChargerClass\Content\Items\Weapons\BloontoniumBlaster.cs", "C#", 41, 0, 0, 0, 0, 0, 9, 50
"c:\Users\Karl\Documents\My Games\Terraria\tModLoader\ModSources\ChargerClass\Content\Items\Weapons\Blowers\Blowguns\HellfireBlowgun.cs", "C#", 0, 0, 0, 0, 0, 0, -1, -1
"c:\Users\Karl\Documents\My Games\Terraria\tModLoader\ModSources\ChargerClass\Content\Items\Weapons\Bola.cs", "C#", -1, 0, 0, 0, 0, 0, 0, -1
"c:\Users\Karl\Documents\My Games\Terraria\tModLoader\ModSources\ChargerClass\Content\Items\Weapons\BunnyGun.cs", "C#", 59, 0, 0, 0, 0, 0, 6, 65
"c:\Users\Karl\Documents\My Games\Terraria\tModLoader\ModSources\ChargerClass\Content\Items\Weapons\ChargeWeapon.cs", "C#", 5, 0, 0, 0, 0, 0, 1, 6
"c:\Users\Karl\Documents\My Games\Terraria\tModLoader\ModSources\ChargerClass\Content\Items\Weapons\CompoundBow.cs", "C#", 3, 0, 0, 0, 0, 0, 0, 3
"c:\Users\Karl\Documents\My Games\Terraria\tModLoader\ModSources\ChargerClass\Content\Items\Weapons\ConsumingLens.cs", "C#", 21, 0, 0, 0, 0, 0, 1, 22
"c:\Users\Karl\Documents\My Games\Terraria\tModLoader\ModSources\ChargerClass\Content\Items\Weapons\Crossbows\CopperCrossbow.cs", "C#", 7, 0, 0, 0, 0, 0, 0, 7
"c:\Users\Karl\Documents\My Games\Terraria\tModLoader\ModSources\ChargerClass\Content\Items\Weapons\Crossbows\CrimtaneCrossbow.cs", "C#", 3, 0, 0, 0, 0, 0, 0, 3
"c:\Users\Karl\Documents\My Games\Terraria\tModLoader\ModSources\ChargerClass\Content\Items\Weapons\Crossbows\IronCrossbow.cs", "C#", 8, 0, 0, 0, 0, 0, 0, 8
"c:\Users\Karl\Documents\My Games\Terraria\tModLoader\ModSources\ChargerClass\Content\Items\Weapons\Crossbows\LeadCrossbow.cs", "C#", 3, 0, 0, 0, 0, 0, 0, 3
"c:\Users\Karl\Documents\My Games\Terraria\tModLoader\ModSources\ChargerClass\Content\Items\Weapons\Crossbows\PlatinumCrossbow.cs", "C#", 3, 0, 0, 0, 0, 0, 0, 3
"c:\Users\Karl\Documents\My Games\Terraria\tModLoader\ModSources\ChargerClass\Content\Items\Weapons\Crossbows\SilverCrossbow.cs", "C#", 6, 0, 0, 0, 0, 0, 1, 7
"c:\Users\Karl\Documents\My Games\Terraria\tModLoader\ModSources\ChargerClass\Content\Items\Weapons\Crossbows\TinCrossbow.cs", "C#", 3, 0, 0, 0, 0, 0, 0, 3
"c:\Users\Karl\Documents\My Games\Terraria\tModLoader\ModSources\ChargerClass\Content\Items\Weapons\Crossbows\TungstenCrossbow.cs", "C#", 3, 0, 0, 0, 0, 0, 0, 3
"c:\Users\Karl\Documents\My Games\Terraria\tModLoader\ModSources\ChargerClass\Content\Items\Weapons\DartlingGun.cs", "C#", 41, 0, 0, 0, 0, 0, 9, 50
"c:\Users\Karl\Documents\My Games\Terraria\tModLoader\ModSources\ChargerClass\Content\Items\Weapons\DragonsBreath.cs", "C#", 42, 0, 0, 0, 0, 0, 6, 48
"c:\Users\Karl\Documents\My Games\Terraria\tModLoader\ModSources\ChargerClass\Content\Items\Weapons\HandCannon.cs", "C#", 1, 0, 0, 0, 0, 0, 0, 1
"c:\Users\Karl\Documents\My Games\Terraria\tModLoader\ModSources\ChargerClass\Content\Items\Weapons\HydraRocketLauncher.cs", "C#", 41, 0, 0, 0, 0, 0, 9, 50
"c:\Users\Karl\Documents\My Games\Terraria\tModLoader\ModSources\ChargerClass\Content\Items\Weapons\LaserDartlingGun.cs", "C#", 48, 0, 0, 0, 0, 0, 10, 58
"c:\Users\Karl\Documents\My Games\Terraria\tModLoader\ModSources\ChargerClass\Content\Items\Weapons\LongBow.cs", "C#", 3, 0, 0, 0, 0, 0, 1, 4
"c:\Users\Karl\Documents\My Games\Terraria\tModLoader\ModSources\ChargerClass\Content\Items\Weapons\MegaMortar.cs", "C#", 40, 0, 0, 0, 0, 0, 6, 46
"c:\Users\Karl\Documents\My Games\Terraria\tModLoader\ModSources\ChargerClass\Content\Items\Weapons\NikolasObliterator.cs", "C#", 40, 0, 0, 0, 0, 0, 6, 46
"c:\Users\Karl\Documents\My Games\Terraria\tModLoader\ModSources\ChargerClass\Content\Items\Weapons\PotatoCannon.cs", "C#", 10, 0, 0, 0, 0, 0, 0, 10
"c:\Users\Karl\Documents\My Games\Terraria\tModLoader\ModSources\ChargerClass\Content\Items\Weapons\RailRailGun.cs", "C#", 49, 0, 0, 0, 0, 0, 6, 55
"c:\Users\Karl\Documents\My Games\Terraria\tModLoader\ModSources\ChargerClass\Content\Items\Weapons\Railgun.cs", "C#", 30, 0, 0, 0, 0, 0, 5, 35
"c:\Users\Karl\Documents\My Games\Terraria\tModLoader\ModSources\ChargerClass\Content\Items\Weapons\RayOfBloon.cs", "C#", 55, 0, 0, 0, 0, 0, 11, 66
"c:\Users\Karl\Documents\My Games\Terraria\tModLoader\ModSources\ChargerClass\Content\Items\Weapons\RocketBalloon.cs", "C#", 41, 0, 0, 0, 0, 0, 6, 47
"c:\Users\Karl\Documents\My Games\Terraria\tModLoader\ModSources\ChargerClass\Content\Items\Weapons\Rubberband.cs", "C#", 3, 0, 0, 0, 0, 0, 0, 3
"c:\Users\Karl\Documents\My Games\Terraria\tModLoader\ModSources\ChargerClass\Content\Items\Weapons\RubberbandGun.cs", "C#", -4, 0, 0, 0, 0, 0, 0, -4
"c:\Users\Karl\Documents\My Games\Terraria\tModLoader\ModSources\ChargerClass\Content\Items\Weapons\ScorchingScream.cs", "C#", 7, 0, 0, 0, 0, 0, 0, 7
"c:\Users\Karl\Documents\My Games\Terraria\tModLoader\ModSources\ChargerClass\Content\Items\Weapons\Slingshots\AntlerSlinger.cs", "C#", 4, 0, 0, 0, 0, 0, 0, 4
"c:\Users\Karl\Documents\My Games\Terraria\tModLoader\ModSources\ChargerClass\Content\Items\Weapons\Slingshots\AshwoodSlingshot.cs", "C#", 3, 0, 0, 0, 0, 0, 0, 3
"c:\Users\Karl\Documents\My Games\Terraria\tModLoader\ModSources\ChargerClass\Content\Items\Weapons\Slingshots\BorealWoodSlingshot.cs", "C#", 3, 0, 0, 0, 0, 0, 0, 3
"c:\Users\Karl\Documents\My Games\Terraria\tModLoader\ModSources\ChargerClass\Content\Items\Weapons\Slingshots\EbonwoodSlingshot.cs", "C#", 3, 0, 0, 0, 0, 0, 1, 4
"c:\Users\Karl\Documents\My Games\Terraria\tModLoader\ModSources\ChargerClass\Content\Items\Weapons\Slingshots\PalmWoodSlingshot.cs", "C#", 3, 0, 0, 0, 0, 0, 0, 3
"c:\Users\Karl\Documents\My Games\Terraria\tModLoader\ModSources\ChargerClass\Content\Items\Weapons\Slingshots\PearlwoodSlingshot.cs", "C#", 3, 0, 0, 0, 0, 0, 0, 3
"c:\Users\Karl\Documents\My Games\Terraria\tModLoader\ModSources\ChargerClass\Content\Items\Weapons\Slingshots\ReinforcedSlingshot.cs", "C#", 3, 0, 0, 0, 0, 0, 0, 3
"c:\Users\Karl\Documents\My Games\Terraria\tModLoader\ModSources\ChargerClass\Content\Items\Weapons\Slingshots\RichMahoganySlingshot.cs", "C#", 3, 0, 0, 0, 0, 0, 0, 3
"c:\Users\Karl\Documents\My Games\Terraria\tModLoader\ModSources\ChargerClass\Content\Items\Weapons\Slingshots\ShadewoodSlingshot.cs", "C#", 5, 0, 0, 0, 0, 0, 1, 6
"c:\Users\Karl\Documents\My Games\Terraria\tModLoader\ModSources\ChargerClass\Content\Items\Weapons\Slingshots\TripleShot.cs", "C#", 3, 0, 0, 0, 0, 0, 0, 3
"c:\Users\Karl\Documents\My Games\Terraria\tModLoader\ModSources\ChargerClass\Content\Items\Weapons\Slingshots\WoodSlingshot.cs", "C#", 3, 0, 0, 0, 0, 0, 0, 3
"c:\Users\Karl\Documents\My Games\Terraria\tModLoader\ModSources\ChargerClass\Content\Items\Weapons\SnailGun.cs", "C#", 38, 0, 0, 0, 0, 0, 6, 44
"c:\Users\Karl\Documents\My Games\Terraria\tModLoader\ModSources\ChargerClass\Content\Items\Weapons\SpiderBow.cs", "C#", 39, 0, 0, 0, 0, 0, 6, 45
"c:\Users\Karl\Documents\My Games\Terraria\tModLoader\ModSources\ChargerClass\Content\Items\Weapons\SuperSoaker.cs", "C#", 1, 0, 0, 0, 0, 0, 0, 1
"c:\Users\Karl\Documents\My Games\Terraria\tModLoader\ModSources\ChargerClass\Content\Items\Weapons\SupremeCalamari.cs", "C#", 5, 0, 0, 0, 0, 0, 0, 5
"c:\Users\Karl\Documents\My Games\Terraria\tModLoader\ModSources\ChargerClass\Content\Items\Weapons\TeslaCoil.cs", "C#", 58, 0, 0, 0, 0, 0, 6, 64
"c:\Users\Karl\Documents\My Games\Terraria\tModLoader\ModSources\ChargerClass\Content\Prefixes\Absurd.cs", "C#", 38, 0, 0, 0, 0, 1, 1, 40
"c:\Users\Karl\Documents\My Games\Terraria\tModLoader\ModSources\ChargerClass\Content\Prefixes\Anxius.cs", "C#", 36, 0, 0, 0, 0, 1, 2, 39
"c:\Users\Karl\Documents\My Games\Terraria\tModLoader\ModSources\ChargerClass\Content\Prefixes\ChargedPrefix.cs", "C#", 29, 0, 0, 0, 0, 7, 1, 37
"c:\Users\Karl\Documents\My Games\Terraria\tModLoader\ModSources\ChargerClass\Content\Prefixes\Depleated.cs", "C#", 35, 0, 0, 0, 0, 1, 2, 38
"c:\Users\Karl\Documents\My Games\Terraria\tModLoader\ModSources\ChargerClass\Content\Prefixes\Ecstatic.cs", "C#", 36, 0, 0, 0, 0, 1, 2, 39
"c:\Users\Karl\Documents\My Games\Terraria\tModLoader\ModSources\ChargerClass\Content\Prefixes\Exuberant.cs", "C#", 39, 0, 0, 0, 0, 1, 2, 42
"c:\Users\Karl\Documents\My Games\Terraria\tModLoader\ModSources\ChargerClass\Content\Prefixes\Negative.cs", "C#", 36, 0, 0, 0, 0, 1, 2, 39
"c:\Users\Karl\Documents\My Games\Terraria\tModLoader\ModSources\ChargerClass\Content\Prefixes\Neutral.cs", "C#", 36, 0, 0, 0, 0, 1, 2, 39
"c:\Users\Karl\Documents\My Games\Terraria\tModLoader\ModSources\ChargerClass\Content\Prefixes\Static.cs", "C#", 36, 0, 0, 0, 0, 1, 2, 39
"c:\Users\Karl\Documents\My Games\Terraria\tModLoader\ModSources\ChargerClass\Content\Prefixes\SuperChargedPrefix.cs", "C#", 29, 0, 0, 0, 0, 7, 1, 37
"c:\Users\Karl\Documents\My Games\Terraria\tModLoader\ModSources\ChargerClass\Content\Projectiles\BloontoniumDartProjectile.cs", "C#", 39, 0, 0, 0, 0, 0, 4, 43
"c:\Users\Karl\Documents\My Games\Terraria\tModLoader\ModSources\ChargerClass\Content\Projectiles\BolaProjectile.cs", "C#", -3, 0, 0, 0, 0, 0, -1, -4
"c:\Users\Karl\Documents\My Games\Terraria\tModLoader\ModSources\ChargerClass\Content\Projectiles\CustomDartProjectile.cs", "C#", 6, 0, 0, 0, 0, 0, 0, 6
"c:\Users\Karl\Documents\My Games\Terraria\tModLoader\ModSources\ChargerClass\Content\Projectiles\DragonsBreathProjectile.cs", "C#", 33, 0, 0, 0, 0, 0, 5, 38
"c:\Users\Karl\Documents\My Games\Terraria\tModLoader\ModSources\ChargerClass\Content\Projectiles\FlamingRubberbandProjectile.cs", "C#", -55, 0, 0, 0, 0, -2, -14, -71
"c:\Users\Karl\Documents\My Games\Terraria\tModLoader\ModSources\ChargerClass\Content\Projectiles\HandCannonBombProjectile.cs", "C#", 19, 0, 0, 0, 0, 0, 1, 20
"c:\Users\Karl\Documents\My Games\Terraria\tModLoader\ModSources\ChargerClass\Content\Projectiles\HolyCrossProjectile.cs", "C#", 88, 0, 0, 0, 0, 0, 10, 98
"c:\Users\Karl\Documents\My Games\Terraria\tModLoader\ModSources\ChargerClass\Content\Projectiles\HotPotatoProjectile.cs", "C#", -36, 0, 0, 0, 0, 0, -5, -41
"c:\Users\Karl\Documents\My Games\Terraria\tModLoader\ModSources\ChargerClass\Content\Projectiles\IceSpikeProjectile.cs", "C#", -42, 0, 0, 0, 0, 0, -6, -48
"c:\Users\Karl\Documents\My Games\Terraria\tModLoader\ModSources\ChargerClass\Content\Projectiles\LightningProjectile.cs", "C#", 6, 0, 0, 0, 0, 0, 0, 6
"c:\Users\Karl\Documents\My Games\Terraria\tModLoader\ModSources\ChargerClass\Content\Projectiles\MiniCannonballProjectile.cs", "C#", -36, 0, 0, 0, 0, 0, -5, -41
"c:\Users\Karl\Documents\My Games\Terraria\tModLoader\ModSources\ChargerClass\Content\Projectiles\MonkeyDartProjectile.cs", "C#", 39, 0, 0, 0, 0, 0, 4, 43
"c:\Users\Karl\Documents\My Games\Terraria\tModLoader\ModSources\ChargerClass\Content\Projectiles\NectarNailProjectile.cs", "C#", 4, 0, 0, 0, 0, 0, -1, 3
"c:\Users\Karl\Documents\My Games\Terraria\tModLoader\ModSources\ChargerClass\Content\Projectiles\PotatoProjectile.cs", "C#", 3, 0, 0, 0, 0, 0, 1, 4
"c:\Users\Karl\Documents\My Games\Terraria\tModLoader\ModSources\ChargerClass\Content\Projectiles\PremeCalamariLaser.cs", "C#", 9, 0, 0, 0, 0, 0, 1, 10
"c:\Users\Karl\Documents\My Games\Terraria\tModLoader\ModSources\ChargerClass\Content\Projectiles\RayOfBloonLaser.cs", "C#", 57, 0, 0, 0, 0, 0, 6, 63
"c:\Users\Karl\Documents\My Games\Terraria\tModLoader\ModSources\ChargerClass\Content\Projectiles\RocketBalloonProjectile.cs", "C#", 37, 0, 0, 0, 0, 0, 5, 42
"c:\Users\Karl\Documents\My Games\Terraria\tModLoader\ModSources\ChargerClass\Content\Projectiles\RocketPodProjectile.cs", "C#", 41, 0, 0, 0, 0, 0, 5, 46
"c:\Users\Karl\Documents\My Games\Terraria\tModLoader\ModSources\ChargerClass\Content\Projectiles\Rocks\ExplodingRockProjectile.cs", "C#", 0, 0, 0, 0, 0, 0, -1, -1
"c:\Users\Karl\Documents\My Games\Terraria\tModLoader\ModSources\ChargerClass\Content\Projectiles\ScorchingScreamProjectile.cs", "C#", -39, 0, 0, 0, 0, 0, -6, -45
"c:\Users\Karl\Documents\My Games\Terraria\tModLoader\ModSources\ChargerClass\Content\Projectiles\SnailProjectile.cs", "C#", 36, 0, 0, 0, 0, 0, 5, 41
"c:\Users\Karl\Documents\My Games\Terraria\tModLoader\ModSources\ChargerClass\Content\Projectiles\SuperSoakerProjectile.cs", "C#", 0, 0, 0, 0, 0, 1, -1, 0
"c:\Users\Karl\Documents\My Games\Terraria\tModLoader\ModSources\ChargerClass\Content\Projectiles\TronboneSonicProjectile.cs", "C#", 2, 0, 0, 0, 0, 0, -1, 1
"c:\Users\Karl\Documents\My Games\Terraria\tModLoader\ModSources\ChargerClass\Content\UI\ChargeMeter\ChargeMeter.cs", "C#", 2, 0, 0, 0, 0, 0, 0, 2
"c:\Users\Karl\Documents\My Games\Terraria\tModLoader\ModSources\ChargerClass\Localization\en-US.hjson", "Hjson", 0, 0, 0, -961, 0, 0, -215, -1176
"c:\Users\Karl\Documents\My Games\Terraria\tModLoader\ModSources\ChargerClass\Properties\launchSettings.json", "JSON", 0, 0, -16, 0, 0, 0, 0, -16
"c:\Users\Karl\Documents\My Games\Terraria\tModLoader\ModSources\ChargerClass\README.md", "Markdown", 0, -2, 0, 0, 0, 0, -1, -3
"Total", "-", 299, -2, -16, -961, -13, -6, -212, -911